21
21
1
17
#####################
#..................S#
#...................#
#...................#
#...................#
#...................#
#...................#
#...................#
#...................#
#...................#
######.##############
#...................#
################.####
#..............#....#
#..............#....#
################....#
#u....#.............#
#.....#........#....#
#.....##########....#
#...................#
#####################
