21
21
10
19
#####################
#..................S#
#...................#
#...................#
#...................#
#...................#
#......#.....#......#
#......#.....#......#
#......#.....#......#
#......#.....#......#
########.....########
#......#.....#......#
########.....########
#......#.....#......#
#......#.....#......#
########.....########
#.....#.......#.....#
#.....#.......#.....#
#.....#.......#.....#
#.....#.......#.....#
##########.##########
